MMMMMMMMMMMMMMMMMMRRRRMMMMMMMMMM
M00000000V0000000MRRRRM00000000M
MAAAAAAA0V000T000MRRRRM00000000M
M00000000V000T000MMMMMMMMMM0MMMM
MAAAAAAA00000T00000000000000000M
M00000000V000000000AAAAAAAAAAA0M
MAAAAAAA0M00000MMM0000000000000M
M0000000MMMMMMMM000AAAAAAAAAAA0M
MAAAAAAA0MRRRRRMMM0000000000000M
M00000000MRRRRRM000AAAAAAAAAAA0M
MAAAAAAA0MRRRRRMMM0000000000000M
MAAAAAAA0V0000000V0PPPPPPPPPPP0M
M00000000V0TTTTT0V0000000000000M
MAAAAAAA00000000000AAAA00PAAAA0M
M00000000MMMMMMMMM0000000000000M
MMMMMMMM0MRRRRRRRM0AAAA000AAAA0M
MBBBBBBB0MRRRRRRRM0000000000000M
MBBBBBBB0MRRRRRRRM0AAAA000AAAA0M
MBBBBBBB0MRRRRRRRM0000000000000M
M000000000000000000AAAA000AAAA0M
MMMMMMMMMMMMM00MMM0000000000000M
RRRRRRRRRRRRM00MRM0AAAA00PAAAA0M
MMMMMMMMMMMMM00MRM0000000000000M
M00000T0T0T0M00MRMMMMMMMMMMMMMMM
M00000T0T0T0000MMMMMMM000000000M
M00000T0T0T0000000000000TTT0P00M
M0000000000000000M000000TTT0000M
MMMMMMMMMM0000000V0000000000000M
RRRRRRRRRM0000000V0M0MMMMMMMMMMM
RRRRRRRRRM00000000000000TTTMRRRR
RRRRRRRRRM0000000V000000TTTMRRRR
RRRRRRRRRM0000M00MMMMMMMMMMMRRRR
MMMMMMMMMM0000M00V000000000MRRRR
P00000000000C0M00000TTTTT00MRRRR
E0000000000000000V000000000MRRRR
MMMMMMMMMMMMMMMMMMMMMMMMMMMMRRRR