111111111111111
10P0000C0000E11
111111111111111
