111111111111111
10P00#0C0000E11
111111111111111
