111111111111111111
1P01001011000000E1
110001001001011111
111000000011000C11
111111111111111111
