111111111111111111
1P0100101100000E01
110001001001011111
111000000011000C11
111111111111111111
