MMMMMMMMMMMMM
M00M0000000CM
M0000MMMMM00M
MP00MME00000M
MMMMMMMMMMMMM
